Pololu3piPlus2040	KEYWORD1

readBatteryMillivolts	KEYWORD2

##############################################

BumpSide	KEYWORD1

BumpRight	LITERAL1
BumpLeft	LITERAL1

BumpSensors	KEYWORD1

calibrate	KEYWORD2
read	KEYWORD2
leftChanged	KEYWORD2
leftIsPressed	KEYWORD2
rightChanged	KEYWORD2
rightIsPressed	KEYWORD2

##############################################

ButtonA	KEYWORD1
ButtonB	KEYWORD1
ButtonC	KEYWORD1

##############################################

PlayMode	KEYWORD1
PLAY_AUTOMATIC	LITERAL1
PLAY_CHECK	LITERAL1

NOTE_C	KEYWORD2
NOTE_C_SHARP	KEYWORD2
NOTE_D_FLAT	KEYWORD2
NOTE_D	KEYWORD2
NOTE_D_SHARP	KEYWORD2
NOTE_E_FLAT	KEYWORD2
NOTE_E	KEYWORD2
NOTE_F	KEYWORD2
NOTE_F_SHARP	KEYWORD2
NOTE_G_FLAT	KEYWORD2
NOTE_G	KEYWORD2
NOTE_G_SHARP	KEYWORD2
NOTE_A_FLAT	KEYWORD2
NOTE_A	KEYWORD2
NOTE_A_SHARP	KEYWORD2
NOTE_B_FLAT	KEYWORD2
NOTE_B	KEYWORD2

SILENT_NOTE	LITERAL1
DIV_BY_10	LITERAL1

Buzzer	KEYWORD1
playFrequency	KEYWORD2
playNote	KEYWORD2
play	KEYWORD2
playMode	KEYWORD2
playCheck	KEYWORD2
isPlaying	KEYWORD2
stopPlaying	KEYWORD2

##############################################

Encoders	KEYWORD1
flipEncoders	KEYWORD2
init	KEYWORD2
getCountsLeft	KEYWORD2
getCountsRight	KEYWORD2
getCountsAndResetLeft	KEYWORD2
getCountsAndResetRight	KEYWORD2

##############################################

LSM6DSO_ADDR	LITERAL1
LIS3MDL_ADDR	LITERAL1

LSM6DSO_REG_WHO_AM_I	LITERAL1
LSM6DSO_REG_CTRL1_XL	LITERAL1
LSM6DSO_REG_CTRL2_G	LITERAL1
LSM6DSO_REG_CTRL3_C	LITERAL1
LSM6DSO_REG_STATUS_REG	LITERAL1
LSM6DSO_REG_OUTX_L_G	LITERAL1
LSM6DSO_REG_OUTX_L_XL	LITERAL1

LIS3MDL_REG_WHO_AM_I	LITERAL1
LIS3MDL_REG_CTRL_REG1	LITERAL1
LIS3MDL_REG_CTRL_REG2	LITERAL1
LIS3MDL_REG_CTRL_REG3	LITERAL1
LIS3MDL_REG_CTRL_REG4	LITERAL1
LIS3MDL_REG_STATUS_REG	LITERAL1
LIS3MDL_REG_OUT_X_L	LITERAL1

IMUType	KEYWORD1
Unknown	LITERAL1
LSM6DSO_LIS3MDL	LITERAL1

IMU	KEYWORD1
a	KEYWORD2
g	KEYWORD2
m	KEYWORD2
getLastError	KEYWORD2
init	KEYWORD2
getType	KEYWORD2
enableDefault	KEYWORD2
configureForTurnSensing	KEYWORD2
configureForFaceUphill	KEYWORD2
configureForCompassHeading	KEYWORD2
writeReg	KEYWORD2
readReg	KEYWORD2
readAcc	KEYWORD2
readGyro	KEYWORD2
readMag	KEYWORD2
read	KEYWORD2
accDataReady	KEYWORD2
gyroDataReady	KEYWORD2
magDataReady	KEYWORD2

##############################################

YellowLED	KEYWORD1
set	KEYWORD2

ledYellow	KEYWORD2

RGB	KEYWORD1
r	KEYWORD2
g	KEYWORD2
b	KEYWORD2

HSV	KEYWORD1
h	KEYWORD2
s	KEYWORD2
v	KEYWORD2

BLACK	LITERAL1
WHITE	LITERAL1
RED	LITERAL1
ORANGE	LITERAL1
YELLOW	LITERAL1
GREEN	LITERAL1
BLUE	LITERAL1
VIOLET	LITERAL1

BACK_LEFT_LED	LITERAL1
BACK_CENTER_LED	LITERAL1
BACK_RIGHT_LED	LITERAL1
FRONT_RIGHT_LED	LITERAL1
FRONT_CENTER_LED	LITERAL1
FRONT_LEFT_LED	LITERAL1

RGBLEDs	KEYWORD1
setAutoShow	KEYWORD2
show	KEYWORD2
setBrightness	KEYWORD2
set	KEYWORD2
hsv2rgb	KEYWORD2
off	KEYWORD2

##############################################

LineSensorsReadMode	KEYWORD1
Off	LITERAL1
On	LITERAL1
Manual	LITERAL1

LineSensors	KEYWORD1
getTimeout	KEYWORD2
calibrate	KEYWORD2
resetCalibration	KEYWORD2
read	KEYWORD2
readCalibrated	KEYWORD2
readLineBlack	KEYWORD2
readLineWhite	KEYWORD2
calibrationOn	KEYWORD2
calibrationOff	KEYWORD2
emittersOn	KEYWORD2
emittersOff	KEYWORD2

CalibrationData	KEYWORD1
minimum	KEYWORD2
maximum	KEYWORD2
initialized	KEYWORD2
init	KEYWORD2

##############################################

Motors	KEYWORD1

flipLeftMotor	KEYWORD2
flipRightMotor	KEYWORD2
setLeftSpeed	KEYWORD2
setRightSpeed	KEYWORD2
setSpeeds	KEYWORD2

##############################################

OLED	KEYWORD1

##############################################
